3 3 3 3 3 3 3 3 3 3 3 3 3 3 3 3 3 3 3 3 3 3 3 3 3 3 3 3
3 1 1 1 1 1 1 1 1 1 1 1 1 3 3 1 1 1 1 1 1 1 1 1 1 1 1 3
3 1 3 3 3 3 1 3 3 3 3 3 1 3 3 1 3 3 3 3 3 1 3 3 3 3 1 3
3 1 3 3 3 3 1 3 3 3 3 3 1 3 3 1 3 3 3 3 3 1 3 3 3 3 1 3
3 1 3 3 3 3 1 3 3 3 3 3 1 3 3 1 3 3 3 3 3 1 3 3 3 3 1 3
3 1 1 2 1 1 2 1 1 1 1 1 1 1 1 1 2 1 1 1 1 1 1 1 1 1 1 3
3 1 3 3 3 3 1 3 3 3 1 3 3 3 3 3 3 1 3 3 3 1 3 3 3 3 1 3
3 1 3 3 3 3 1 3 3 3 1 3 3 3 3 3 3 1 3 3 3 1 3 3 3 3 1 3
3 1 1 1 1 1 1 3 3 3 1 1 1 3 3 1 1 1 3 3 3 1 1 1 1 1 1 3
3 2 3 3 3 3 2 3 3 3 3 3 1 3 3 1 3 3 3 3 3 2 3 3 3 3 1 3
3 1 3 3 3 3 1 3 3 3 3 3 1 3 3 1 3 3 3 3 3 1 3 3 3 3 1 3
3 1 3 3 3 3 1 3 3 3 3 3 1 3 3 1 3 3 3 3 3 1 3 3 3 3 1 3
3 1 3 3 3 3 1 3 3 9 1 1 1 1 1 1 1 1 9 3 3 1 3 3 3 3 1 3
3 1 1 1 1 1 1 1 1 1 3 3 3 3 3 3 3 3 1 1 1 1 1 1 1 1 1 3
3 1 3 3 3 3 1 3 3 1 3 8 8 8 8 8 8 3 1 3 3 1 3 3 3 3 1 3
3 1 3 3 3 3 1 3 3 1 3 8 8 8 8 8 8 3 1 3 3 1 3 3 3 3 1 3
3 1 3 3 3 3 1 3 3 1 3 3 3 3 3 3 3 3 1 3 3 1 3 3 3 3 1 3
3 1 3 3 3 3 1 3 3 9 1 1 1 1 1 1 1 1 9 3 3 1 3 3 3 3 1 3
3 1 3 3 3 3 1 3 3 1 3 3 3 3 3 3 3 3 1 3 3 1 3 3 3 3 1 3
3 1 3 3 3 3 1 3 3 1 3 3 3 3 3 3 3 3 1 3 3 1 3 3 3 3 1 3
3 1 3 3 3 3 1 3 3 1 3 3 3 3 3 3 3 3 1 3 3 1 3 3 3 3 1 3
3 1 1 1 1 1 1 1 1 1 1 1 1 3 3 1 1 1 1 1 1 1 1 1 1 1 1 3
3 1 3 3 3 3 1 3 3 3 3 3 1 3 3 1 3 3 3 3 3 1 3 3 3 3 1 3
3 1 1 1 3 3 1 3 3 3 3 3 1 3 3 1 3 3 3 3 3 1 3 3 1 1 1 3
3 3 3 1 3 3 1 3 3 3 3 3 1 3 3 1 3 3 3 3 3 1 3 3 1 3 3 3
3 3 3 1 3 3 1 1 1 1 1 1 1 1 1 1 1 1 1 1 1 2 3 3 1 3 3 3
3 1 1 1 1 1 1 3 3 1 3 3 3 3 3 3 3 3 1 3 3 1 1 1 1 1 1 3
3 1 3 3 3 3 3 3 3 1 1 1 3 3 3 3 1 1 1 3 3 3 3 3 3 3 1 3
3 1 3 3 3 3 3 3 3 3 3 1 3 3 3 3 1 3 3 3 3 3 3 3 3 3 1 3
3 1 1 1 1 1 1 1 1 1 1 1 1 1 1 1 1 1 1 1 1 1 1 1 1 1 1 3
3 3 3 3 3 3 3 3 3 3 3 3 3 3 3 3 3 3 3 3 3 3 3 3 3 3 3 3